#############
#-----------#
#-----------#
#-----@-$--.#
#-----------#
#-----------#
#############
