#############
#-----------#
#-----------#
#.--$-@-$--.#
#-----------#
#-----------#
#############
