#############
#----.#---@-#
#---###-----#
#--####---$.#
#--$--------#
#-----------#
#############
