#############
#.----------#
#---------$-#
#-----@-----#
#-$---------#
#----------.#
#############
