#############
#.-----$-#-@#
###-##-#---##
#--$---#-#$##
#-#-$###-#-##
#.---.##---.#
#############
