-------------
--#########--
###-------###
#.---$@$---.#
###-------###
--#########--
-------------
