--######-----
--#----#-----
--#----#####-
--#.$--%-@-#-
--#----#####-
--#----#-----
--######-----
