####---------
#..#---------
#..##########
#.-$--$--$--#
#$$--------@#
#------######
########-----
